#############################
#---------------------------#
#--###----------------------#
#--#W#----###########-------#
#--###----#----#----#-------#
#---------#----#----#-------#
#---------#-----------------#
X---------###---------------#
#--------------------####---#
#----------------------M#---#
#--------------------M--#---#
#-----#--#-------------M#---#
#----------#---------####---#
#---------------------------#
#############################
