------AA-AA----AA-------------A-----------------------------------~~-----------------A------A-------AA----
---AAA--A--AAAA--AAA--------AA---------------------------------~~~---------------------AA---A----A--------
--A--Y-----YY----Y--A----AAA---------------------------------~~------------------------------A------------
AA--Y---Y----Y----Y-A-AAA------------------------------------~--------------------------------------------
AYY--X---Y--------Y-OAO--------------------------------------~--------------------------------------------
A--Y---YY----YY------AA------------------------------------~~---------------------------------------------
-A---------------------A----------------------------------~-----Y-----------------------------------------
-A--Y-----YY------YY---A----------------------------------~~-----~~----Y----------------------------------
AY----Y-----Y--Y------A------------------------------------~~~~~~~~~~~------------------------------------
A~Y~--Y--------Y--Y----A---------AA-----------------------Y-----~~~~~~~~~~~-------------------------------
A~Y~~~---Y----Y----Y--A-----------AA---------------------------~~~~~~~~~~~~~~---------#-------------------
-AYY~~Y----AA---AA---A-------------AA-----------------------~~~~~~~~~~~~~----------#-----#----------------
--A~~AAAA-A--AAA--AAA---------------AA----A-------------------Y~~~~~~~~---Y-----------X#------------------
---AA----A---------------------------AAAA----A-AA--------------Y--------YY-----------#--------------------
--A------------------------------------AAAAAA-------------------------------------------#-----------------
--AA-------------------------------------AAAAAAAA---------------------------------------------------------
-A-A----------------------------------AA--AAAAAA--A-------------------------------------------------------
----AA---------------------------------A-AAAAAAAAA--------------------------------------------------------
-----AA------------------------------------AAAO-AAAA------------------------------------------------------
----AAA-----------------------------------A----A--AA------------------------------------------------------
--AAA--------------------------------Y------------AA-----------------------W------W-----------------------
---AA----------------------------------Y--------AAA-------------------W------------W----------------------
A-AA------------------------------------------AAA--------Y---------W---WW-W--WWW--------------------------
AAA--X---------------------------------------AAA-----Y----------------W--W-WWW--WW-W-------------------A--
A--A-------------------------------------------AAA-----YY------------WWWW-WWWWWWW-W---W-----------------AA
-------------------------------------Y-----------AAA-----------------W-W-WWWWWWWWWW-W-----------------AA--
--------------------------Y------YY--------------------------------W--W-WWWWWOWWWW----WW-----------AAA----
------------------Y---------Y--------------Y--------------------------WWW-WWWWWWWW-WW--------------AA-----
----------Y-----------------------Y------Y--------Y-----Y-----------W----W-WWWWWW-W-W--W------------AA----
---------------Y------------------Y---------------------------------W--WW-W-W---WW----W------------A-AA---
--------------Y---------------Y-------Y---------------------------------W-----W---W---------------A--AA---
--------------------------Y------------------Y------------------------W---W------W------------------AA----
-------------------YY-----------YY-----------Y------Y-------------------------------------------AAAA------
-------------------------------------Y------Y--------------------------------------------------AAA--------
-----YY-----Y----------Y----Y----------------------------------------------------------------AAA----------
------------------Y---Y-----------------Y--------------Y------------------------A-----------AA------------
-----------------Y----------------------------------YY---------A---------A-A---A-----A---AA-AA------------
-------Y-------------A------------------------------------------------------AAA-AAAAA---A---A-------------
-----------------#####AA-----------------------------------------AA-AA---AA---AAA~AAAAAAA-AAA-------------
-----------------A------A---A-------------------------------------------A---AAAA~~~~AAAAAAAO--------------
------------Y----A--O---A----AA------A-------------------------~~----Y---A~~~~~~~~~~~AAA--AA--------------
------Y--------AA#----A--AA--A--AA---------------------------X--~~~~---Y~~~-AAAAA~~AAA--AAA---------------
---YY------Y---A-####--##------AAA--A-------------------------~~~~~~~~~~~------AAA~AAAAA--A---------------
--------------------AA------AA-----AAA---------------------------~~~~----A---AAAAA~A-A-AA-----------------
--Y--------AAA------A--A-------AA-AAA--------------------------Y-----AAA----AA---A~A----------------------
--------A------Y------###---AAA--------A--A--------------------AA-A---------------~-----------------------
-------A---A-----Y---A#----AAA--AA--AAA----A----------------A---------------------~-----------------------
----AA----------------AA---#-A-----A---A------------------AA---------------------~~-----------------------
------A------YY-------######-AAA----AA--A----------------A----------------------~~--------------Y---Y-----
-A------Y--------Y--------A------------A----------------------------------------~------------A--Y--A---YY-
----A--AAA----------Y------------A-------------------AAA---------------------~~~--------------AA-----Y----
----A---------------Y-------------------------------A-----------------------~-------------------A------AA-
-AA-------Y-----YY----------------------------------------------------------~-----------------Y------A----
------Y--------Y-------------------------AA----------A-------------------~~~---------------YY--AA---------
-YY------------------------------AAA-AAA---A-A--AAAA----------------~~~~~------------------------Y----Y---
---Y--------Y------------------AA---------------------------------X~-------------------------A------AY--Y-
-------Y----------------------A------------------------------------~------------------------A-Y----------Y
