#################...#############
#T..............................#
#...............................#
#...............................#
#...............................#
#...............................#
#...............................#
#...............................#
#~~~.................#######....#
#~~~~~~~~....#...#.........#....#
#~........~~.#.X.#...#.....#....#
#..........~~#####...#.....#..TT#
#~..........~~~......#######....#
#~~~.......~~~~~..............TT#
#################################
