#################################
#~~~~~~~............-----------.#
#~~##################.-####---.~#
#~~#----------------#--#--#.-..~#
#~-#----------------#--#--#~~~~~#
#~-###-########-----#--#--#######
#~------------#-----#--#--#-----#
#--#----------#######--#--#-----#
#--#----------#-----#--#--------#
#--#-~~-------------#--#######--#
#--#----------#-----#-----------#
##-######---###-----##########--#
#-----#~-----~#--------#-------~#
#-----#~-----~#------------~~~~~#
##########X######################
