AAAAAAAAAAAAAAAAAAAAAAAAAAAAAAAAAAAAAAA
AA--A----AAA-AA-A--WWAAA----AA-AAAAAAAA
AAA-~~------AAWW--W----W--WW---A--~~AAA
AA-~~~~-----A---W---WAAA-----WA--~~~~-A
A-A-~~---AW-AA-W-WW---W-AW---AW---~~-AA
A--------A----AW-----W-WA----AA-------A
A---------A---AAW--W--WW-A-----AA-----A
AAA-AAA----A----AA---W--WWA-----------A
AA-A---A--AA------AAAW-W--AAAA--AW---AA
A-A-A-A-AA-------A---A----W---AAWA-WW-A
AAAWAA-AA----------X-AAWW---WW---AW---A
AW----WAA----------AA----W---AAAA---WAA
A---W-WA---AA----AA----W----AA----WAAAA
AA-W---WA----AAAA-----WAAA-WA---------A
AA--WW--A------------AAA-WAA-W-------AA
A-W------AA---------AA-W----------W--AA
A-W---WW---W--------AWW-------AAW---WWA
AA--W----WW---WAA---A----------A---W--A
AA--AW-W--A--A-------AA-W-B-W-A-WW--WAA
AAAAAAAA---AAAA---A---AA-WWW---AA-WAAAA
AAAAAAAAAAAAAAAAAAAAAAAAAAAAAAAAAAAAAAA
