.........##########.........
.........#..#..#..#.........
.........#........#.........
....######........######....
....#....#.##..##.#....#....
....#..................#....
....#....#........#....#....
....#######.####.#######....
......&&&#........#&&&......
........&####..####&........
.........&&&....&&&.........
.............X..............
