..X.........~~~~~~~~~~~~~~~~
.........~~~~~~~~~~~~~~~~~~~
...~~~-~~~~~~~~~~~~~~~~~~~~~
~~~~~~-~~~~~~~~~~~~~~~~~~~~~
~~~~~~-~~~~~~~~~~~~~~~~~~~~~
~~~----#######~~~~~~~~~~~~~~
~~~----------#~~~~~~~~~~~~~~
~~~-------------~~~~~~~~~~~~
~~~-#-#---------~~~~~~~~~~~~
~~~-----------~~~~~~~~~~~~~~
~~~~~~~~~~~~~~~~~~~~~~~~~~~~
~~~~~~~~~~~~~~~~~~~~~~~~~~~~
