AAAA.AA.AAAAAAA..AAAAAAAA..AA.AAAA..AAAAAAA.A.
..--AAAAA-AA--AAAA------AAA..A----AA.-----AA.A
X.-------AA---------------..--A----------...A.
...--------AA--------------------------------A
.A----------A----AA------------------AA------A
A----AA------AAAA-------AA----------AA-----A-A
A-----AA--------------AAAAA-----------------A.
A-------AA-------------AA-------------------A.
.A--------A--------------------AAAAA--------.A
A-AA------A-----AAAA----------A-----AA------AA
AA.A-------AA--A----AA------AA--------A------A
.A.A..-------AA-------A--------------A-------A
A.A.AAA-------------AA-------------AA--.----AA
AA.A.A.AAA.----.AAAA-AAAA..------AA......-AA..
.AA.AAA.A.AAAAAA.AA.AA.A.AAAAAAAAA...X..AA..A.
