##############X##################
#--------#-------------------A--#
#--------#-----------~AA--------#
#-----####---------~~~~~--------#
#-----------------~~~~~---------#
##########----------~~----------#
#A--------------------------A---#
#--A---------------A------------#
#-------------------#############
#-------------------------#A----#
####-######-#-----A-#-----#---A-#
#-----#-----#----A--#-----#AA---#
#-----#-----#-------#######--A--#
#-----#-----#--------A---A------#
#################################
