~~~~~~~~~~~~~~~~~~~~~~~~~~~~~~~~~~~AAAAAAA----X---AAA....
~~~~~~~~A~~~~~~~~~~~A~~~~~~~~~~AAAAAAA------------AAAAA..
~~A~~~~~~~~~~~~~~~~A~~~~~~~AAAAAAA-----------------AAA...
~~~~~~~~~~~AA~~~~~~~~~AAAAAAAA---------AAA----------AA...
--~~~A~~~~~~~A~~~~AAAAAAAA-------AAAAAA------A------AAA--
-------~~~~~~~~AAAAAA-----AAAAAAA-------------------AAAA-
---------------AAA------------------------A-------AAAA---
--A---AA---A--AAA--A-----------AAAA--------A---AAAAA-----
-----A--------AA-----------AAAA----AA---------AAAA----A--
---------A---AAA-----A---AA----------AA--------AA--------
-A--AA-----AAAAA-------AA-------A------AA------AA-A--A---
-A------A--AAAA------AAA----------------A-----AAAA-------
------------AA------A--------------A---A----AAAA--A------
---A-A---AAAAA-A---A------A---AAA-------AAAAAAAAA---A----
----------AAA---------------AAAAAAA---AAAAA--------------
-A-----AAAAA------------AAAAAAA--AAAAAAAAA----AA----A----
--A-AAAAAA-----------AAAAA-----------AA----------A--A----
----AAA----------A--AAA----A---------A-----A---------A---
-A-AAA---A--------AAA---------A-----A---A----------------
----AAA----------AAA---A----------------A------A---A-----
-AAAAA-A--------AAAAAA-----AA-----A-----------A----------
----AA-----X---AAA-----------A---------------------------
