#################################
#~~~~~~~............---------...#
#~~##################.-####---.~#
#~~#---..------.--..#--#--#.-..~#
#~-#----------------#--#--#~~~~~#
#~-###-########-----#--#--#######
#~------------#-----#--#--#-----#
#--#----------#######--#--#-----#
#--#----------#-----#--#--------#
#--#-~~-------------#--#######--#
#--#----------#-----#-----------#
##-######---###-----##########--#
#-----#~-----~#--------#------.~#
#-----#~-----~#----------..~~~~~#
##########X######################
