AAAAAAAAAAAAAAAAAAAAAAAAAA-A--X-A
A----A----AA---A-----AAA-AA-----A
A-A--------AA-----AAAAA---------A
A----A---------AAA-----AAAA-----A
A-------AAA---A-----#------A----A
A----AAA------A--#-----#---A----A
A---A----------A-----------A----A
A---A-----AA---A------AA--A-----A
AA---AA----A----AA------AA-----AA
A------AA---------A-------------A
A---------A-------A--AA---------A
AAAA-------A------AAA----------AA
A---AAA----A----------------AAAAA
AA-----AAAAA----~----------A----A
AA-------------~~~----AA-------AA
A---A------------#------AA-----AA
A---A-----AAAAA----------AA-----A
A---A----A-----AA-------A--A----A
A--A-----A---A---AA--------A----A
A--A----AA--A-----A---A-----A---A
A------A-------A-------AA-AA----A
A-----AA-A--AA----A-----------AAA
A--X-AAAAAAAAAAAAAAAAAAAAAAAAAAAA
